^ H H H & 2 2 2 2 2 ^ H H H &
V - - - V g g g g g V - - - V
V - - - V g g g g g V - - - V
V - - - V g g g g g V - - - V
* H - H ( g g g g g * H - H (
5 g P g g g g g g g g g P g 3
5 g • p p p p † p p p p ª g 3
5 g g g g g g P g g g g g g 3
5 g g g g g g P g g g g g g 3
8 4 4 4 4 4 4 P 4 4 4 4 4 4 9