™ ™ ™ c ™ w w ™ ™ ™ ™ ™ ™ ™ ctr
cl g g g g w w g g g g g g g cr
cl g g g g w w g g g g g g g cr
cl g g g g w w w w w g g g g cr
cl g g g g w w w w w g g g g cr
cl g g g g g g g w w g g g g cr
cl g g g g g g g w w w w w w w
cl g g g g g g g w w w w w w w
cl g g g g g g g g g g g g g cr
cl g g g g g g g g g g g g g cr