^ H H H H & 2 P 2 2 2 2 2 2 7
V - - - - V g P g f f f f f 3
V - - - - V g P g f f f f f 3
V - - - - V g P g f f f f f 3
V - - - - V g P g g g g P g 3
V - - - - V g P g g g g P 4 9
V - - - - - p © p p p p © p p
V - - - - V g g g g g g g 2 7
V - - - - V g g g g g g g g 3
* H H H H ( 4 4 4 4 4 4 4 4 9