 œ  ™  ™  ™  ™  ™  ™  ™  ™  ™  ™  ™  ™  ™  ´
 ∞ c1 c1 c1 c1 c1 c1 c1 c1 c1 c1 c1 c1 c1  £
 ∞ c1 c2 c2 c1 c1 c2 c3 c3 c3 c3 c3 c3  w  £
 ∞ c2 c1 c2 c1 c1 c3  w  w  w  w  -  w  w  £
c2 c2 c2 c1 c2 c3  w  w  w  w  w  -  w  w  £
 ∞ c2 c2 c2 c3  w  w  w  w c3 c3 c3 c3  w  £
 ∞ c2 c2 c1 c3  w  w  w c3 c1 c2 c1 c2 c3  £
 ∞ c2 c2 c2 c3  w  w c3 c1 c2 c2 c1 c2 c2  £
 ∞ c2 c2 c2 c3  w  w c3 c1 c2 c2 c1 c2 c1  £
 ∑  ¢  ¢ c3  ¢  w  w  ¢  ¢  ¢ c3 c3  ¢  ¢  ®