5  ct  ct  ct  ct  ct  ct  ct  ct  ct  ct  ct  ct  ct  ct
5   g   g   g   g   g   g   g   g   g   g   g   g   g   g
5   g   g   g   g   g   g   g   g   g   g   g   g   g   g
5   g   g   g   g   g   g   g   g   g   g   g   g   g   g
5   g   g   g   g   g   g   g   g   g ctl  cb  cb  cb  cb
5   g   g   g   g   g   g   g   g   g  cl   g   g   g   g
g   g   g   g   g   g   g   g   g   g cbl  ct  ct  ct ctr
5   g   g   g   g   g   g   g   g   g   g   g   g   g  cr
5   g   g   g   g   g   g   g   g   g   g   g   g   g  cr
5   g   g   g   g   g   g   g   g   g   g   g   g   g  cr