ct  ct  ct  ct  ct  ct  ct  ct  ct  ct  ct  ct  ct  ct  ct
g    g   g   g   g   g   g   g   g   g   g   g   g   g   g
g    g   g   g   g   g   g   g   g   g   g   g   g   g   g
g    g   g   g   g   g   g   g   g   g   g   g   g   g   g
g    g   g   g   g   g   g   g   g   g   g   g   g   g   g
g    g   g   g   g   g   g   g   g   g   g   g   g   g   g
g    g   g   g   g   g   g   g   g   g   g   g   g   g   g
g    g   g   g   g   g   g   g   g   g   g   g   g   g   g
g    g   g   g   g   g   g   g   g   g   g   g   g   g   g
cbl cb  cb  cb  cb  cb  cb  cb  cb  cb  cb  cb  cb  cb  cb