6 2 2 2 2 2 2 x 2 2 2 2 2 2 7
5 x x x x 1 x x x 1 x x x x 3
5 x x x x 1 x x x 1 x x x x 3
5 x x x x 1 x x x 1 x x x x 3
5 x x x x 1 x x x 1 x x x x x
5 x x x x 1 1 x 1 1 x x x x 3
5 x x x x x x x x x x x x x 3
5 x x x x x x x x x x x x x 3
5 x x x x x x x x x x x x x 3
8 4 4 4 4 4 4 4 4 4 4 4 4 4 9