ctl  g   g   g   g   g   g   g   g   g   g   g   g   g   cr
cl   g   g   g   g   g   g   g   g   g   g   g   g   g   cr
cl   g   g   g   g   g   g   g   g   g   g   g   g   g   cr
cl   g   g   g   g   g   g   g   g   g   g   g   g   g   cr
cl   g   g   g   g   g   g   g   g   g   g   g   g   g   cr
cl   g   g   g   g   g   g   g   g   g   g   g   g   g   cr
cl   g   g   g   g   g   g   g   g   g   g   g   g   g   cr
cl   g   g   g   g   g   g   g   g   g   g   g   g   g   cr
cl   g   g   g   g   g   g   g   g   g   g   g   g   g   cr
cbl cb  cb  cb  cb  cb  cb  cb  cb  cb  cb  cb  cb  cb  cbr