ct  ct  ct  ct  ct  ct  ct  ct  ct  ct  ct  ct  ct  ct  ct
g    g   g   g   g   g   g   g   g   g   g   g   g   g   g
g    g   g   g   g   g   g   g   g   g   g   g   g   g   g
g    g   g   g   g   g   g   g   g   g   g   g   g   g   g
cb  cb  cb ctr   g   g   g   g   g   g   g   g   g   g   g
g    g   g  cr   g   g   g   g   g   g   g   g   g   g   g
ctr  g   g  cr   g   g   g   g   g   g   g   g   g   g   g
cr   g   g   g   g   g   g   g   g   g   g   g   g   g   g
cr   g   g  cr   g   g   g   g   g   g   g   g   g   g   g
cbl cb  cb  cb  cb  cb  cb  cb  cb  cb  cb  cb  cb  cb  cb