6 2 2 2 2 w w 2 2 2 2 2 2 2 7
5 x x x x w w x x x x x x x 3
5 x x x x w w x x x x x x x 3
5 x x x x w w w w w x x x x 3
x x x x x w w w w w x x x x x
5 x x x x x x x w w x x x x 3
5 x x x x x x x w w x x x x 3
5 x x x x x x x w w x x x x 3
5 x x x x x x x w w x x x x 3
8 4 4 4 4 4 4 x w w 4 4 4 4 9