5  ct  ct  ct  ct  ct  ct  ct  ct  ct   ct  ct  ct  ct  ct
5   g   g   g   g   g   g   g   g   g    g   g   g   g   g
5   g   g   g   g   g   g   g   g   g    g   g   g   g   g
5   g   g   g   g   g   g   g   g   g    g   g   g   g   g
5   g   g   g   g   g   g   g   g   g ctli  cb  cb  cb  cb
5   g   g   g   g   g   g   g   g   g   cr   g   g   g   g
g   g   g   g   g   g   g   g   g   g cbli  ct  ct  ct ctr
5   g   g   g   g   g   g   g   g   g    g   g   g   g  cr
5   g   g   g   g   g   g   g   g   g    g   g   g   g  cr
5   g   g   g   g   g   g   g   g   g    g   g   g   g  cr