ct  ct  ct  ct  ct  ct  ct  ct  ct  ct  ct  ct  ct  ct  ct
g    g   g   g   g   g   g   g   g   g   g   g   g   g   g
g    g   g   g   g   g   g   g   g   g   g   g   g   g   g
g    g   g   g   g   g   g   g   g   g   g   g   g   g   g
g    g   g   g   g   g   g   g   g   g   g   g   g   g   g
g    g   g   g   g   g   g   g   g   g   g   g   g   g   g
g    g   g   g   g   g   g   g   g   g   g   g   g   g   g
g    g   g   g   g   g   g   g   g   g   g   g   g   g   g
g    g   g   g   g   g   g   g   g   g   g   g   g   g   g
cb  cb  cb  cb  cb  cb  cb  cb  cb  cb  cb  cb  cb  cb  cb