ct  ct  ct   ct   ct  ct  ct  ct  ct  ct  ct  ct  ct  ct  ct
g    g   g    g    g   g   g   g   g   g   g   g   g   g   g
g    g   g    g    g   g   g   g   g   g   g   g   g   g   g
g    g   g    g    g   g   g   g   g   g   g   g   g   g   g
cb  cb  cb ctri    g   g   g   g   g   g   g   g   g   g   g
g    g   g   cl    g   g   g   g   g   g   g   g   g   g   g
ctr  g   g   cl    g   g   g   g   g   g   g   g   g   g   g
cr   g   g    g    g   g   g   g   g   g   g   g   g   g   g
cr   g   g   cl    g   g   g   g   g   g   g   g   g   g   g
cbli ct  ct  cbri ctli  cb  cb  cb  cb  cb  cb  cb  cb  cb  cb