6 2 2 g 2 w w 2 2 2 2 2 2 2 7
5 g g g g w w g g g g g g g 3
5 g g g g w w g g g g g g g 3
5 g g g g w w w w w g g g g 3
g g g g g w w w w w g g g g g
5 g g g g g g g w w g g g g 3
5 g g g g g g g w w w w w w w
5 g g g g g g g w w w w w w w
5 g g g g g g g g g g g g g 3
5 g g g g g g g g g g g g g 3