6 2 2 2 2 2 2 2 2 2 2 2 2 2 7
5 - - - - - - - - - - - - - 3
5 - - - - - - - - - - - - - 3
5 - - - - - - - - - - - - - 3
5 - - - - - - - - - - - - - 3
5 - - - - - - - - - - - - - -
5 - - - - - - - - - - - - - 3
5 - - - - - - - - - - - - - 3
5 - - - - - - - - - - - - - 3
8 4 4 4 4 4 4 4 4 4 4 4 4 4 9