5 g g g g g g g g g g g g g 3
5 g g g g g g g g g g g g g 3
5 g g g g g g g g g g g g g 3
5 g g g g g g g g g g g g g 3
5 g g g g g g g g g g g g g 3
5 g g g g g g g g g g g g g 3
g g g g g g g g g g g g g g 3
5 g g g g g g g g g g g g g 3
5 g g g g g g g g g g g g g 3
8 4 4 4 4 4 4 4 4 4 4 4 4 4 9