^    H    H     H  H & g P g f f f f f 3
V    -   -3     -  - V g P g f f f f f 3
V    - -bl1    -2 -1 V g P g f f f f f 3
V    -    -     -  - V g P g f f f f f 3
V tab1    -     -  - V g P g g g g P g 3
V    -    -  tab1  - V g P g g g g P g 3
V tab1    -     -  - - p © p p p p © p p
V    -    -     -  - V g g g g g g g g 3
V    -    -     -  - V g g g g g g g g 3
*    H    H     H  H ( 4 4 4 4 4 4 4 4 9