œ ™ ™ ™ ™ ™ ™ ™ ™ ™ ™ ™ ™ ™ ´
∞ c c c c c c c c c c c c c £
∞ c c c c c c c c c c c c w £
∞ c c c c c c w w w w - w w £
c c c c c c w w w w w - w w £
∞ c c c c w w w w c c c c w £
∞ c c c c w w w c c c c c c c
∞ c c c c w w c c c c c c c c
∞ c c c c w w c c c c c c c £
∑ ¢ ¢ c ¢ w w ¢ ¢ ¢ ¢ ¢ ¢ ¢ ®